4 0 0 4 0 0 4 0 0 4 0 0 4 0 0 4 0 0 4 0 0 4 0 0 4 0 0 4 0 0 4 0 0 4 0 0 4 0 0 4 0 0 4 0 0 4 0 0 4 0 0 4 0 0 4 0 0 4 0 0 4 0 0 4 0 0 4 0 0 4 0 0 4 0 0 4 0 0 4 0 0 4 0 0 4 0 0 4 0 0 4 0 0 4 0 0 4 0 0 4 0 0 
4 0 0 4 0 0 4 0 0 4 0 0 4 0 0 4 0 0 4 0 0 4 0 0 4 0 0 4 0 0 4 0 0 4 0 0 4 0 0 4 0 0 4 0 0 4 0 0 4 0 0 4 0 0 4 0 0 4 0 0 4 0 0 4 0 0 4 0 0 4 0 0 4 0 0 4 0 0 4 0 0 4 0 0 4 0 0 4 0 0 4 0 0 4 0 0 4 0 0 4 0 0 
4 0 0 1 0 0 1 7 0 1 0 0 1 0 0 1 0 0 1 0 0 1 0 0 1 0 0 1 0 0 1 0 0 1 0 0 1 0 0 1 0 0 1 0 0 1 0 0 1 0 0 1 0 0 1 7 0 1 0 0 1 0 0 1 0 0 1 0 0 1 0 0 1 0 0 1 0 0 1 0 0 1 0 0 1 7 0 1 7 0 1 0 0 1 0 0 1 0 0 4 0 0 
4 0 0 1 0 0 1 0 0 1 0 0 1 0 0 1 0 0 1 0 0 1 0 0 1 0 0 1 0 0 1 0 0 1 0 0 1 0 0 1 0 0 1 0 0 1 0 0 1 6 0 1 0 0 1 0 0 1 0 0 1 0 0 1 0 0 1 0 0 1 0 0 1 7 0 1 0 0 1 0 0 1 0 0 1 0 0 1 0 0 1 7 0 1 0 0 1 0 0 4 0 0 
4 0 0 1 0 0 1 0 0 1 0 0 1 7 0 1 8 0 1 0 0 1 0 0 1 0 0 1 7 0 1 0 0 1 0 0 1 0 0 1 0 0 1 0 0 1 0 0 1 0 0 1 0 0 1 7 0 1 0 0 1 0 0 1 0 0 1 0 0 1 7 0 1 0 0 1 0 0 1 7 0 1 0 0 1 0 0 1 0 0 1 0 0 1 0 0 1 0 0 4 0 0 
4 0 0 1 0 0 1 6 0 1 0 0 1 0 0 1 0 0 1 0 0 1 0 0 1 0 0 1 0 0 1 0 0 1 7 0 1 0 0 1 0 0 1 0 0 1 0 0 1 0 0 1 0 0 1 0 0 1 0 0 1 0 0 1 0 0 1 0 0 1 0 0 1 0 0 1 0 0 1 0 0 1 0 0 1 0 0 1 0 0 1 0 0 1 0 0 1 0 0 4 0 0 
4 0 0 1 0 0 1 0 0 1 0 0 1 0 0 1 0 0 1 7 0 1 0 0 1 0 0 1 0 0 1 0 0 1 0 0 1 0 0 1 0 0 1 0 0 1 7 0 1 0 0 1 0 0 1 0 0 1 0 0 1 6 0 1 0 0 1 0 0 1 0 0 1 0 0 1 0 0 1 0 0 1 0 0 1 0 0 1 3 0 1 0 0 1 0 0 1 0 0 4 0 0 
4 0 0 1 7 0 1 0 0 1 0 0 1 0 0 1 3 0 1 0 0 1 0 0 1 0 0 1 7 0 1 0 0 1 0 0 1 0 0 1 0 0 1 7 0 1 0 0 1 0 0 1 0 0 1 0 0 1 0 0 1 0 0 1 0 0 1 0 0 1 7 0 1 0 0 1 0 0 1 0 0 1 0 0 1 0 0 1 0 0 1 0 0 1 0 0 1 7 0 4 0 0 
4 6 0 1 0 0 1 0 0 1 0 0 1 0 0 1 0 0 1 0 0 1 0 0 1 0 0 1 0 0 1 3 0 1 0 0 1 0 0 1 3 0 1 0 0 1 0 0 1 0 0 1 0 0 1 0 0 1 7 0 1 0 0 1 0 0 1 0 0 1 0 0 1 0 0 1 0 0 1 7 0 1 0 0 1 0 0 1 0 0 1 0 0 1 0 0 1 0 0 4 0 0 
4 0 0 1 0 0 1 0 0 1 0 0 1 7 0 1 0 0 1 0 0 1 0 0 1 7 0 1 0 0 1 0 0 1 0 0 1 0 0 1 0 0 1 0 0 1 0 0 1 0 0 1 0 0 1 0 0 1 0 0 1 6 0 1 0 0 1 0 0 1 0 0 1 0 0 1 0 0 1 0 0 1 0 0 1 0 0 1 0 0 1 0 0 1 0 0 1 7 0 4 0 0 
4 0 0 1 0 0 1 0 0 1 0 0 1 0 0 1 0 0 1 0 0 1 0 0 1 0 0 1 0 0 1 0 0 1 0 0 1 0 0 1 0 0 1 0 0 1 0 0 1 0 0 1 7 0 1 0 0 1 0 0 1 0 0 1 0 0 1 0 0 1 0 0 1 0 0 1 0 0 1 0 0 1 0 0 1 0 0 1 0 0 1 0 0 1 0 0 1 0 0 4 0 0 
4 0 0 1 0 0 1 6 0 1 0 0 1 0 0 1 0 0 1 0 0 1 0 0 1 0 0 1 0 0 1 0 0 1 0 0 1 0 0 1 0 0 1 0 0 1 0 0 1 0 0 1 0 0 1 0 0 1 0 0 1 0 0 1 0 0 1 0 0 1 0 0 1 0 0 1 0 0 1 0 0 1 0 0 1 3 0 1 0 0 1 0 0 1 0 0 1 0 0 4 0 0 
4 0 0 1 7 0 1 0 0 1 7 0 1 0 0 1 0 0 1 7 0 1 3 0 1 0 0 1 0 0 1 0 0 1 7 0 1 0 0 1 0 0 1 0 0 1 0 0 1 7 0 1 0 0 1 0 0 1 0 0 1 7 0 1 7 0 1 0 0 1 0 0 1 0 0 1 0 0 1 0 0 1 7 0 1 0 0 1 0 0 1 7 0 1 0 0 1 0 0 4 0 0 
4 0 0 1 7 0 1 0 0 1 0 0 1 0 0 1 0 0 1 0 0 1 0 0 1 0 0 1 0 0 1 0 0 1 0 0 1 0 0 1 0 0 1 0 0 1 0 0 1 0 0 1 0 0 1 0 0 1 0 0 1 3 0 1 0 0 1 0 0 1 0 0 1 0 0 1 0 0 1 0 0 1 0 0 1 0 0 1 0 0 1 0 0 1 0 0 1 0 0 4 0 0 
4 0 0 1 0 0 1 0 0 1 0 0 1 0 0 1 0 0 1 0 0 1 0 0 1 0 0 1 0 0 1 0 0 1 7 0 1 0 0 1 0 0 1 0 0 1 0 0 1 0 0 1 0 0 1 0 0 1 0 0 1 7 0 1 0 0 1 0 0 1 0 0 1 0 0 1 0 0 1 0 0 1 0 0 1 0 0 1 0 0 1 0 0 1 0 0 1 0 0 4 0 0 
4 0 0 1 0 0 1 7 0 1 0 0 1 0 0 1 0 0 1 0 0 1 7 0 1 0 0 1 0 0 1 0 0 1 0 0 1 0 0 1 0 0 1 0 0 1 0 0 1 0 0 1 0 0 1 0 0 1 7 0 1 0 0 1 0 0 1 6 0 1 0 0 1 7 0 1 0 0 1 0 0 1 7 0 1 0 0 1 0 0 1 0 0 1 0 0 1 0 0 4 0 0 
4 7 0 1 0 0 1 0 0 1 0 0 1 0 0 1 0 0 1 0 0 1 0 0 1 0 0 1 0 0 1 3 0 1 0 0 1 0 0 1 0 0 1 0 0 1 7 0 1 0 0 1 0 0 1 0 0 1 7 0 1 0 0 1 0 0 1 0 0 1 0 0 1 0 0 1 0 0 1 0 0 1 0 0 1 0 0 1 0 0 1 7 0 1 7 0 1 3 0 4 0 0 
4 0 0 1 0 0 1 0 0 1 0 0 1 0 0 1 0 0 1 6 0 1 7 0 1 7 0 1 0 0 1 7 0 1 0 0 1 0 0 1 3 0 1 0 0 1 0 0 1 0 0 1 0 0 1 0 0 1 0 0 1 0 0 1 0 0 1 0 0 1 0 0 1 0 0 1 0 0 1 0 0 1 0 0 1 0 0 1 0 0 1 0 0 1 0 0 1 0 0 4 0 0 
4 0 0 1 7 0 1 0 0 1 7 0 1 0 0 1 0 0 1 0 0 1 7 0 1 0 0 1 0 0 1 0 0 1 0 0 1 0 0 1 0 0 1 0 0 1 0 0 1 7 0 1 0 0 1 0 0 1 0 0 1 7 0 1 0 0 1 0 0 1 7 0 1 0 0 1 0 0 1 7 0 1 0 0 1 0 0 1 7 0 1 0 0 1 0 0 1 0 0 4 0 0 
4 0 0 1 0 0 1 0 0 1 0 0 1 0 0 1 0 0 1 0 0 1 0 0 1 0 0 1 0 0 1 0 0 1 7 0 1 0 0 1 0 0 1 0 0 1 0 0 1 0 0 1 0 0 1 0 0 1 0 0 1 0 0 1 0 0 1 0 0 1 0 0 1 0 0 1 0 0 1 0 0 1 0 0 1 0 0 1 0 0 1 0 0 1 0 0 1 0 0 4 0 0 
4 0 0 4 0 0 4 0 0 4 0 0 4 0 0 4 0 0 4 0 0 4 0 0 4 0 0 4 0 0 4 0 0 4 0 0 4 0 0 4 0 0 4 0 0 4 0 0 4 0 0 4 0 0 4 0 0 4 0 0 4 0 0 4 0 0 4 0 0 4 0 0 4 0 0 4 0 0 4 0 0 4 0 0 4 0 0 4 0 0 4 0 0 4 0 0 4 0 0 4 0 0 
